....XXXXXXXX
.X.....XXXXX
pXX...X.@XXX
.X.X....X.XX
.X.X.X.X..X.
...X.X...X.X
